Path = [(21, 2), (21, 1), (21, 0), (20, 0), (19, 0), (19, 1), (19, 2), (19, 3), (19, 4), (19, 5), (19, 6), (18, 6), (18, 7), (17, 7), (16, 7), (16, 6), (16, 5), (16, 4), (16, 3), (16, 2), (16, 1), (16, 0), (15, 0), (14, 0), (13, 0), (12, 0), (11, 0), (11, 1), (11, 2)]

['0', '0', '0', '0', '0', '0', '0', '0', '0', '0', '0', '0', '0', '0', '0', '0', '0', '0', '0', '0', '0', '0', '0', '0', '0']
['0', '0', '0', '0', '0', '0', '0', '0', '0', '0', '0', '0', '0', '0', '0', '0', '0', '0', '1', '1', '0', '0', '0', '0', '0']
['0', '0', '0', '0', '0', '0', '0', '0', '0', '0', '1', '1', '1', '0', '0', '0', '0', '0', '1', '1', '0', '0', '0', '0', '0']
['0', '0', '0', '0', '0', '0', '1', '1', '0', '0', '1', '1', '1', '0', '0', '0', '0', '0', '1', '1', '0', '0', '0', '0', '0']
['1', '1', '1', '0', '0', '0', '1', '1', '0', '0', '1', '1', '1', '0', '0', '0', '0', '0', '1', '1', '0', '0', '0', '0', '0']
['1', '1', '1', '0', '0', '0', '1', '1', '0', '0', '1', '1', '1', '0', '0', '0', '0', '0', '1', '1', '1', '1', '0', '0', '0']
['0', '0', '1', '0', '0', '0', '1', '1', '0', '0', '1', '1', '1', '0', '0', '0', '0', '0', '1', '1', '1', '1', '1', '1', '0']
['0', '0', '1', '1', '1', '0', '1', '1', '0', '0', '1', '1', '1', '0', '0', '0', '0', '0', '1', '0', '0', '0', '0', '0', '0']
['0', '0', '1', '1', '1', '0', '0', '0', '0', '0', '0', '0', '0', '0', '0', '0', '0', '0', '1', '0', '0', '1', '0', '0', '0']
['0', '0', '0', '0', '0', '0', '0', '0', '0', '0', '0', '0', '0', '0', '0', '0', '0', '0', '1', '0', '0', '1', '0', '0', '0']
['0', '0', '0', '0', '0', '0', '0', '0', '0', '0', '0', '0', '0', '0', '0', '1', '1', '0', '1', '0', '0', '1', '0', '0', '0']
[' ', ' ', 'x', '0', '1', '0', '0', '0', '0', '0', '0', '0', '0', '0', '0', '1', '1', '0', '1', '0', '0', '1', '0', '0', '0']
[' ', '0', '0', '0', '0', '0', '0', '0', '0', '0', '1', '0', '0', '0', '0', '1', '1', '0', '1', '0', '0', '1', '0', '0', '1']
[' ', '0', '0', '0', '0', '0', '0', '0', '0', '0', '1', '0', '0', '0', '0', '1', '1', '0', '0', '0', '0', '1', '1', '1', '1']
[' ', '0', '0', '0', '0', '0', '0', '0', '1', '1', '1', '1', '1', '0', '0', '1', '1', '0', '0', '0', '0', '0', '1', '1', '1']
[' ', '0', '0', '0', '0', '0', '0', '0', '0', '0', '1', '0', '0', '0', '0', '0', '0', '0', '0', '0', '0', '0', '0', '1', '1']
[' ', ' ', ' ', ' ', ' ', ' ', ' ', ' ', '0', '0', '1', '0', '0', '0', '0', '0', '0', '0', '0', '0', '0', '0', '0', '0', '1']
['1', '1', '1', '1', '1', '1', '1', ' ', '1', '0', '0', '0', '0', '0', '0', '0', '0', '0', '0', '0', '0', '0', '0', '0', '0']
['0', '0', '0', '1', '1', '1', ' ', ' ', '1', '1', '1', '0', '0', '0', '1', '1', '1', '1', '1', '1', '1', '0', '0', '0', '0']
[' ', ' ', ' ', ' ', ' ', ' ', ' ', '0', '1', '1', '1', '0', '0', '0', '0', '0', '0', '0', '0', '0', '0', '0', '0', '0', '0']
[' ', '0', '0', '1', '1', '1', '0', '0', '1', '1', '1', '0', '0', '0', '1', '1', '1', '1', '1', '1', '1', '0', '0', '0', '0']
[' ', ' ', 'x', '1', '1', '1', '0', '0', '1', '0', '0', '0', '0', '0', '1', '1', '1', '1', '1', '1', '1', '0', '0', '0', '0']
['1', '1', '1', '1', '1', '0', '0', '0', '1', '0', '0', '0', '0', '0', '1', '1', '1', '1', '1', '1', '1', '0', '0', '0', '0']
['1', '1', '1', '1', '1', '1', '1', '1', '1', '1', '0', '0', '0', '0', '0', '0', '0', '0', '0', '0', '0', '0', '0', '0', '0']
['0', '0', '0', '0', '1', '1', '0', '0', '0', '0', '0', '0', '0', '0', '0', '0', '0', '1', '1', '0', '0', '0', '0', '0', '0']
