Path = [(21, 2), (20, 2), (19, 2), (19, 3), (19, 4), (19, 5), (19, 6), (19, 7), (18, 7), (17, 7), (16, 7), (15, 7), (14, 7), (13, 7), (12, 7), (12, 6), (12, 5), (12, 4), (12, 3), (11, 3), (11, 2)]

['0', '0', '0', '0', '0', '0', '0', '0', '0', '0', '0', '0', '0', '0', '0', '0', '0', '0', '0', '0', '0', '0', '0', '0', '0']
['0', '0', '0', '0', '0', '0', '0', '0', '0', '0', '0', '0', '0', '0', '0', '0', '0', '0', '1', '1', '0', '0', '0', '0', '0']
['0', '0', '0', '0', '0', '0', '0', '0', '0', '0', '1', '1', '1', '0', '0', '0', '0', '0', '1', '1', '0', '0', '0', '0', '0']
['0', '0', '0', '0', '0', '0', '1', '1', '0', '0', '1', '1', '1', '0', '0', '0', '0', '0', '1', '1', '0', '0', '0', '0', '0']
['1', '1', '1', '0', '0', '0', '1', '1', '0', '0', '1', '1', '1', '0', '0', '0', '0', '0', '1', '1', '0', '0', '0', '0', '0']
['1', '1', '1', '0', '0', '0', '1', '1', '0', '0', '1', '1', '1', '0', '0', '0', '0', '0', '1', '1', '1', '1', '0', '0', '0']
['0', '0', '1', '0', '0', '0', '1', '1', '0', '0', '1', '1', '1', '0', '0', '0', '0', '0', '1', '1', '1', '1', '1', '1', '0']
['0', '0', '1', '1', '1', '0', '1', '1', '0', '0', '1', '1', '1', '0', '0', '0', '0', '0', '1', '0', '0', '0', '0', '0', '0']
['0', '0', '1', '1', '1', '0', '0', '0', '0', '0', '0', '0', '0', '0', '0', '0', '0', '0', '1', '0', '0', '1', '0', '0', '0']
['0', '0', '0', '0', '0', '0', '0', '0', '0', '0', '0', '0', '0', '0', '0', '0', '0', '0', '1', '0', '0', '1', '0', '0', '0']
['0', '0', '0', '0', '0', '0', '0', '0', '0', '0', '0', '0', '0', '0', '0', '1', '1', '0', '1', '0', '0', '1', '0', '0', '0']
['0', '0', 'x', ' ', '1', '0', '0', '0', '0', '0', '0', '0', '0', '0', '0', '1', '1', '0', '1', '0', '0', '1', '0', '0', '0']
['0', '0', '0', ' ', ' ', ' ', ' ', ' ', '0', '0', '1', '0', '0', '0', '0', '1', '1', '0', '1', '0', '0', '1', '0', '0', '1']
['0', '0', '0', '0', '0', '0', '0', ' ', '0', '0', '1', '0', '0', '0', '0', '1', '1', '0', '0', '0', '0', '1', '1', '1', '1']
['0', '0', '0', '0', '0', '0', '0', ' ', '1', '1', '1', '1', '1', '0', '0', '1', '1', '0', '0', '0', '0', '0', '1', '1', '1']
['0', '0', '0', '0', '0', '0', '0', ' ', '0', '0', '1', '0', '0', '0', '0', '0', '0', '0', '0', '0', '0', '0', '0', '1', '1']
['0', '0', '0', '0', '0', '0', '0', ' ', '0', '0', '1', '0', '0', '0', '0', '0', '0', '0', '0', '0', '0', '0', '0', '0', '1']
['1', '1', '1', '1', '1', '1', '1', ' ', '1', '0', '0', '0', '0', '0', '0', '0', '0', '0', '0', '0', '0', '0', '0', '0', '0']
['0', '0', '0', '1', '1', '1', '0', ' ', '1', '1', '1', '0', '0', '0', '1', '1', '1', '1', '1', '1', '1', '0', '0', '0', '0']
['0', '0', ' ', ' ', ' ', ' ', ' ', ' ', '1', '1', '1', '0', '0', '0', '0', '0', '0', '0', '0', '0', '0', '0', '0', '0', '0']
['0', '0', ' ', '1', '1', '1', '0', '0', '1', '1', '1', '0', '0', '0', '1', '1', '1', '1', '1', '1', '1', '0', '0', '0', '0']
['0', '0', 'x', '1', '1', '1', '0', '0', '1', '0', '0', '0', '0', '0', '1', '1', '1', '1', '1', '1', '1', '0', '0', '0', '0']
['1', '1', '1', '1', '1', '0', '0', '0', '1', '0', '0', '0', '0', '0', '1', '1', '1', '1', '1', '1', '1', '0', '0', '0', '0']
['1', '1', '1', '1', '1', '1', '1', '1', '1', '1', '0', '0', '0', '0', '0', '0', '0', '0', '0', '0', '0', '0', '0', '0', '0']
['0', '0', '0', '0', '1', '1', '0', '0', '0', '0', '0', '0', '0', '0', '0', '0', '0', '1', '1', '0', '0', '0', '0', '0', '0']
