Path = [(24, 24), (23, 24), (22, 24), (21, 24), (20, 24), (19, 24), (18, 24), (17, 24), (17, 23), (16, 23), (16, 22), (15, 22), (15, 21), (14, 21), (14, 20), (13, 20), (13, 19), (13, 18), (13, 17), (12, 17), (11, 17), (10, 17), (9, 17), (8, 17), (7, 17), (6, 17), (5, 17), (4, 17), (3, 17), (2, 17), (1, 17), (0, 17), (0, 16), (0, 15), (0, 14), (0, 13), (0, 12), (0, 11), (0, 10), (0, 9), (0, 8), (0, 7), (0, 6), (0, 5), (0, 4), (0, 3), (0, 2), (0, 1), (0, 0)]

Cost = 49

Cells Visited = 445

['x', ' ', ' ', ' ', ' ', ' ', ' ', ' ', ' ', ' ', ' ', ' ', ' ', ' ', ' ', ' ', ' ', ' ', '0', '0', '0', '0', '0', '0', '0']
['0', '0', '0', '0', '0', '0', '0', '0', '0', '0', '0', '0', '0', '0', '0', '0', '0', ' ', '1', '1', '0', '0', '0', '0', '0']
['0', '0', '0', '0', '0', '0', '0', '0', '0', '0', '1', '1', '1', '0', '0', '0', '0', ' ', '1', '1', '0', '0', '0', '0', '0']
['0', '0', '0', '0', '0', '0', '1', '1', '0', '0', '1', '1', '1', '0', '0', '0', '0', ' ', '1', '1', '0', '0', '0', '0', '0']
['1', '1', '1', '0', '0', '0', '1', '1', '0', '0', '1', '1', '1', '0', '0', '0', '0', ' ', '1', '1', '0', '0', '0', '0', '0']
['1', '1', '1', '0', '0', '0', '1', '1', '0', '0', '1', '1', '1', '0', '0', '0', '0', ' ', '1', '1', '1', '1', '0', '0', '0']
['0', '0', '1', '0', '0', '0', '1', '1', '0', '0', '1', '1', '1', '0', '0', '0', '0', ' ', '1', '1', '1', '1', '1', '1', '0']
['0', '0', '1', '1', '1', '0', '1', '1', '0', '0', '1', '1', '1', '0', '0', '0', '0', ' ', '1', '0', '0', '0', '0', '0', '0']
['0', '0', '1', '1', '1', '0', '0', '0', '0', '0', '0', '0', '0', '0', '0', '0', '0', ' ', '1', '0', '0', '1', '0', '0', '0']
['0', '0', '0', '0', '0', '0', '0', '0', '0', '0', '0', '0', '0', '0', '0', '0', '0', ' ', '1', '0', '0', '1', '0', '0', '0']
['0', '0', '0', '0', '0', '0', '0', '0', '0', '0', '0', '0', '0', '0', '0', '1', '1', ' ', '1', '0', '0', '1', '0', '0', '0']
['0', '0', '0', '0', '1', '0', '0', '0', '0', '0', '0', '0', '0', '0', '0', '1', '1', ' ', '1', '0', '0', '1', '0', '0', '0']
['0', '0', '0', '0', '0', '0', '0', '0', '0', '0', '1', '0', '0', '0', '0', '1', '1', ' ', '1', '0', '0', '1', '0', '0', '1']
['0', '0', '0', '0', '0', '0', '0', '0', '0', '0', '1', '0', '0', '0', '0', '1', '1', ' ', ' ', ' ', ' ', '1', '1', '1', '1']
['0', '0', '0', '0', '0', '0', '0', '0', '1', '1', '1', '1', '1', '0', '0', '1', '1', '0', '0', '0', ' ', ' ', '1', '1', '1']
['0', '0', '0', '0', '0', '0', '0', '0', '0', '0', '1', '0', '0', '0', '0', '0', '0', '0', '0', '0', '0', ' ', ' ', '1', '1']
['0', '0', '0', '0', '0', '0', '0', '0', '0', '0', '1', '0', '0', '0', '0', '0', '0', '0', '0', '0', '0', '0', ' ', ' ', '1']
['1', '1', '1', '1', '1', '1', '1', '0', '1', '0', '0', '0', '0', '0', '0', '0', '0', '0', '0', '0', '0', '0', '0', ' ', ' ']
['0', '0', '0', '1', '1', '1', '0', '0', '1', '1', '1', '0', '0', '0', '1', '1', '1', '1', '1', '1', '1', '0', '0', '0', ' ']
['0', '0', '0', '0', '0', '0', '0', '0', '1', '1', '1', '0', '0', '0', '0', '0', '0', '0', '0', '0', '0', '0', '0', '0', ' ']
['0', '0', '0', '1', '1', '1', '0', '0', '1', '1', '1', '0', '0', '0', '1', '1', '1', '1', '1', '1', '1', '0', '0', '0', ' ']
['0', '0', '0', '1', '1', '1', '0', '0', '1', '0', '0', '0', '0', '0', '1', '1', '1', '1', '1', '1', '1', '0', '0', '0', ' ']
['1', '1', '1', '1', '1', '0', '0', '0', '1', '0', '0', '0', '0', '0', '1', '1', '1', '1', '1', '1', '1', '0', '0', '0', ' ']
['1', '1', '1', '1', '1', '1', '1', '1', '1', '1', '0', '0', '0', '0', '0', '0', '0', '0', '0', '0', '0', '0', '0', '0', ' ']
['0', '0', '0', '0', '1', '1', '0', '0', '0', '0', '0', '0', '0', '0', '0', '0', '0', '1', '1', '0', '0', '0', '0', '0', 'x']
